1 1 1 1 1 1 1 1
1 0 5 2 2 2 0 1
1 2 2 2 2 1 1 1
1 1 1 4 0 1 3 1
1 2 2 2 2 0 0 1
1 1 1 1 1 1 1 1
